OOOOOOOO
OSR O  O
O  BBB O
OSS    O
OOOOOOOO