OOOOOOOOOOO
OSSS  OO  O
ORB B OO  O
OO O SOO  O
O B OOO  OO
O   B     O
O   OOO   O
OOOOO OOOOO