OOOOOOO
O RO  OOOOO
O BB  B   O
O  OSOOBO O
OOBOSSS   O
OO SSSOOBOO
O  OOSOO  O
O  B  B   O
O  O   O  O
OOOOOOOOOOO
